  _________ __                             _____  
 /   _____//  |______     ____   ____     /  |  | 
 \_____  \\   __\__  \   / ___\_/ __ \   /   |  |_
 /        \|  |  / __ \_/ /_/  >  ___/  /    ^   /
/_______  /|__| (____  /\___  / \___  > \____   | 
        \/           \//_____/      \/       |__| 