 #HH||  #|                         #HH|  
##     ##HH| ##|    #HH|  #H|     ##     
 #HH|   #|     H|  ## H| ##HH|    ##HH|  
    ||  #|   ##H|   #HH| ##       ##  || 
##HH|   #H|  ##HH|    H|  #HH|     #HH|  
                   ##H|                  