  _________ __                          ________  
 /   _____//  |______     ____   ____   \_____  \ 
 \_____  \\   __\__  \   / ___\_/ __ \    _(__  < 
 /        \|  |  / __ \_/ /_/  >  ___/   /       \
/_______  /|__| (____  /\___  / \___  > /______  /
        \/           \//_____/      \/         \/ 